"a" = (/turf/space,/area)
"b" = (/turf/simulated/wall/invulnerable/ice,/area/vault/icecomet)
"c" = (/obj/structure/snow_pedestal{light_power = 5; light_range = 10},/obj/item/clothing/head/celtic,/turf/simulated/floor/plating/snow/ice,/area/vault/icecomet)
"d" = (/turf/simulated/floor/plating/snow/ice{light_power = 5; light_range = 10},/area/vault/icecomet)
"e" = (/turf/simulated/floor/plating/snow/ice,/area/vault/icecomet)
"f" = (/obj/machinery/door/mineral/transparent/icicle/horizontal,/turf/simulated/floor/plating/snow/ice,/area/vault/icecomet)
"g" = (/mob/living/simple_animal/hostile/decoy/snowman/frostgolem/wizard,/turf/simulated/floor/plating/snow,/area/vault/icecomet)
"h" = (/obj/structure/snow,/obj/structure/snow,/turf/simulated/floor/plating/snow,/area/vault/icecomet)
"i" = (/obj/jectie_time,/turf/simulated/floor/plating/snow/ice,/area/vault/icecomet)
"j" = (/mob/living/simple_animal/hostile/decoy/snowman/frostgolem/knight,/turf/simulated/floor/plating/snow,/area/vault/icecomet)
"x" = (/mob/living/simple_animal/hostile/humanoid/frostgolem{wander = 0},/turf/simulated/floor/plating/snow/ice,/area/vault/icecomet)
"W" = (/obj/structure/snow,/obj/structure/snow,/obj/jectie_time,/turf/simulated/floor/plating/snow,/area/vault/icecomet)

(1,1,1) = {"
aaaabbbbbaaaa
aabbbbcbbbbaa
abbdebfbedbba
bbgheeeiehgbb
bjhWheeehhhjb
bhhhhhehhhhhb
bjhhhhehhWhjb
bbhhheeehhhbb
abhheeeeehhba
abbeeeeeeebba
abbbbbfbbbbba
aabbxeeexbbaa
aabbheeehbbaa
aabbhhehhbbaa
aaabhhehhbaaa
aaabhhehhbaaa
aaabhhehhbaaa
aaabbhehbbaaa
aaaabhehbaaaa
aaaabhehbaaaa
aaaabeeebaaaa
aaaabbebbaaaa
aaaaabebaaaaa
aaaaabebaaaaa
aaaaabfbaaaaa
"}
