"aa" = (/turf/space,/area/vault/spacepond)
"ab" = (/turf/unsimulated/mineral,/area/vault/spacepond)
"ac" = (/turf/simulated/wall/mineral/wood,/area/vault/spacepond)
"ad" = (/obj/machinery/cooking,/turf/simulated/floor{icon_state = "cafeteria"},/area/vault/spacepond)
"ae" = (/obj/structure/table,/obj/machinery/microwave,/turf/simulated/floor{icon_state = "cafeteria"},/area/vault/spacepond)
"af" = (/obj/structure/table,/obj/item/weapon/kitchen/utensil/knife/large/butch,/obj/item/weapon/kitchen/rollingpin,/obj/item/weapon/reagent_containers/food/drinks/americup,/turf/simulated/floor{icon_state = "cafeteria"},/area/vault/spacepond)
"ag" = (/obj/structure/ladder/spacepond/ground,/turf/simulated/floor/wood,/area/vault/spacepond)
"ah" = (/obj/structure/closet/secure_closet/freezer/fridge,/obj/item/weapon/reagent_containers/food/snacks/meat/carpmeat,/obj/item/weapon/reagent_containers/food/snacks/meat/carpmeat,/obj/item/weapon/reagent_containers/food/snacks/meat/bearmeat,/obj/item/weapon/reagent_containers/food/drinks/flour,/obj/item/weapon/storage/fancy/egg_box,/turf/simulated/floor{icon_state = "cafeteria"},/area/vault/spacepond)
"ai" = (/turf/unsimulated/floor/asteroid,/area/vault/spacepond)
"aj" = (/obj/item/clothing/mask/breath,/obj/item/clothing/head/helmet/space,/turf/unsimulated/floor/asteroid,/area/vault/spacepond)
"ak" = (/obj/machinery/atmospherics/unary/vent_pump{dir = 4; on = 1},/turf/simulated/floor/wood,/area/vault/spacepond)
"al" = (/turf/simulated/floor{icon_state = "cafeteria"},/area/vault/spacepond)
"am" = (/obj/effect/decal/cleanable/flour,/obj/machinery/light/small{dir = 4},/turf/simulated/floor{icon_state = "cafeteria"},/area/vault/spacepond)
"an" = (/obj/item/weapon/broken_bottle,/turf/simulated/floor{icon_state = "cafeteria"},/area/vault/spacepond)
"ao" = (/obj/effect/decal/cleanable/generic,/obj/item/clothing/suit/spaceblanket,/turf/simulated/floor/carpet,/area/vault/spacepond)
"ap" = (/obj/jectie_time,/turf/simulated/floor/wood,/area/vault/spacepond)
"ar" = (/turf/simulated/floor/wood,/area/vault/spacepond)
"as" = (/obj/effect/decal/cleanable/blood,/turf/simulated/floor/wood,/area/vault/spacepond)
"at" = (/obj/effect/decal/cleanable/blood/gibs/up,/obj/effect/decal/cleanable/blood/tracks/footprints{tag = "icon-human1 (NORTH)"; icon_state = "human1"; dir = 1},/turf/simulated/floor/wood,/area/vault/spacepond)
"au" = (/obj/structure/closet/crate/chest/potential_mimic,/obj/item/stack/sheet/wood,/obj/item/weapon/storage/fancy/matchbox/strike_anywhere,/turf/simulated/floor/carpet,/area/vault/spacepond)
"av" = (/obj/machinery/space_heater/campfire/stove/fireplace,/turf/simulated/floor/carpet,/area/vault/spacepond)
"aw" = (/obj/item/clothing/shoes/black,/turf/unsimulated/floor/asteroid,/area/vault/spacepond)
"ax" = (/turf/simulated/floor/wood{broken = 1; icon_state = "wood-broken6"},/area/vault/spacepond)
"ay" = (/obj/item/weapon/tank/oxygen,/turf/unsimulated/floor/asteroid,/area/vault/spacepond)
"aA" = (/obj/effect/decal/cleanable/generic,/obj/structure/hanging_lantern,/turf/simulated/floor/wood,/area/vault/spacepond)
"aB" = (/obj/effect/decal/cleanable/blood/gibs/limb,/turf/unsimulated/floor/asteroid,/area/vault/spacepond)
"aC" = (/turf/simulated/floor/carpet,/area/vault/spacepond)
"aD" = (/obj/abstract/map/spawner/space/drinks,/turf/simulated/floor/carpet,/area/vault/spacepond)
"aE" = (/obj/effect/decal/cleanable/blood,/obj/effect/landmark/corpse,/turf/unsimulated/floor/asteroid,/area/vault/spacepond)
"aF" = (/obj/structure/bed,/obj/effect/decal/cleanable/blood/tracks/footprints{tag = "icon-human2 (NORTH)"; icon_state = "human2"; dir = 1},/obj/item/weapon/bedsheet/brown,/turf/simulated/floor/wood,/area/vault/spacepond)
"aH" = (/obj/structure/bed/chair/comfy/brown{dir = 1},/turf/simulated/floor/carpet,/area/vault/spacepond)
"aI" = (/obj/structure/hanging_lantern{dir = 1},/turf/unsimulated/floor/asteroid,/area/vault/spacepond)
"aJ" = (/obj/structure/coatrack/full,/obj/item/clothing/mask/necklace/xeno_claw,/turf/simulated/floor/wood{broken = 1; icon_state = "wood-broken4"},/area/vault/spacepond)
"aK" = (/obj/machinery/atmospherics/pipe/simple/scrubbers/hidden{dir = 4},/obj/structure/closet,/obj/item/clothing/shoes/blue,/obj/item/clothing/under/bluepants,/obj/item/clothing/under/lawyer/bluesuit,/obj/item/clothing/suit/jumper/christmas/blue,/obj/item/clothing/head/hairflower,/obj/item/clothing/head/bearpelt/real,/obj/item/clothing/head/ushanka,/obj/machinery/light/small{dir = 4},/turf/simulated/floor/wood{broken = 1; icon_state = "wood-broken3"},/area/vault/spacepond)
"aL" = (/obj/machinery/atmospherics/pipe/simple/scrubbers/hidden{dir = 4},/turf/simulated/wall/mineral/wood,/area/vault/spacepond)
"aM" = (/obj/machinery/atmospherics/pipe/simple/scrubbers/hidden{dir = 4},/turf/unsimulated/floor/asteroid,/area/vault/spacepond)
"aN" = (/obj/machinery/atmospherics/pipe/simple/scrubbers/hidden{dir = 4},/turf/unsimulated/mineral,/area/vault/spacepond)
"aO" = (/obj/machinery/atmospherics/unary/vent{dir = 8},/turf/unsimulated/floor/asteroid,/area/vault/spacepond)
"aP" = (/obj/item/clothing/under/overalls,/obj/item/clothing/suit/space,/turf/unsimulated/floor/asteroid,/area/vault/spacepond)
"aQ" = (/obj/effect/decal/cleanable/blood/splatter,/turf/unsimulated/floor/asteroid,/area/vault/spacepond)
"aR" = (/turf/simulated/floor/wood{broken = 1; icon_state = "wood-broken4"},/area/vault/spacepond)
"aS" = (/obj/structure/bed/chair/comfy/brown{dir = 1},/obj/item/clothing/mask/cigarette/pipe,/obj/item/clothing/glasses/regular/hipster,/turf/simulated/floor/carpet,/area/vault/spacepond)
"aU" = (/obj/structure/bookcase,/obj/item/weapon/storage/bible,/turf/simulated/floor/carpet,/area/vault/spacepond)
"aV" = (/obj/machinery/door/mineral/wood,/turf/simulated/floor/wood,/area/vault/spacepond)
"aW" = (/obj/machinery/atmospherics/unary/vent_scrubber/on{dir = 4},/turf/simulated/floor/wood,/area/vault/spacepond)
"aX" = (/obj/item/stack/medical/ointment,/obj/item/stack/medical/bruise_pack,/turf/simulated/floor/wood,/area/vault/spacepond)
"aY" = (/mob/living/simple_animal/hostile/carp/baby,/turf/simulated/floor/wood,/area/vault/spacepond)
"aZ" = (/obj/item/weapon/harpoon,/obj/machinery/light/small{dir = 1},/turf/simulated/floor/wood,/area/vault/spacepond)
"ba" = (/obj/effect/decal/cleanable/blood/tracks/footprints{tag = "icon-human2 (NORTH)"; icon_state = "human2"; dir = 1},/obj/effect/decal/cleanable/blood/tracks/footprints{tag = "icon-human1 (NORTH)"; icon_state = "human1"; dir = 1},/turf/unsimulated/floor/asteroid,/area/vault/spacepond)
"bb" = (/obj/effect/decal/cleanable/blood/tracks/footprints{tag = "icon-human2 (WEST)"; icon_state = "human2"; dir = 8},/obj/effect/decal/cleanable/blood/tracks/footprints{tag = "icon-human1 (NORTH)"; icon_state = "human1"; dir = 1},/turf/unsimulated/floor/asteroid,/area/vault/spacepond)
"bc" = (/obj/structure/flora/pottedplant,/turf/simulated/floor/carpet,/area/vault/spacepond)
"be" = (/obj/machinery/alarm{dir = 8; pixel_x = 24},/obj/machinery/atmospherics/unary/tank/air{dir = 8},/turf/simulated/floor/wood,/area/vault/spacepond)
"bf" = (/obj/structure/window/full/reinforced,/turf/simulated/floor/wood,/area/vault/spacepond)
"bg" = (/mob/living/simple_animal/hostile/carp/baby,/turf/simulated/floor/wood{broken = 1; icon_state = "wood-broken3"},/area/vault/spacepond)
"bh" = (/turf/unsimulated/beach/sand,/area/vault/spacepond)
"bi" = (/obj/jectie_time,/turf/simulated/floor/wood{broken = 1; icon_state = "wood-broken"},/area/vault/spacepond)
"bj" = (/obj/effect/decal/cleanable/blood/drip,/turf/unsimulated/floor/asteroid,/area/vault/spacepond)
"bk" = (/turf/unsimulated/beach/water,/area/vault/spacepond)
"bl" = (/obj/effect/decal/cleanable/blood/tracks/footprints{tag = "icon-human2 (NORTH)"; icon_state = "human2"; dir = 1},/obj/effect/decal/cleanable/blood/tracks/footprints{tag = "icon-human1 (WEST)"; icon_state = "human1"; dir = 8},/turf/unsimulated/floor/asteroid,/area/vault/spacepond)
"bm" = (/obj/structure/window/full/reinforced,/turf/simulated/floor/wood{broken = 1; icon_state = "wood-broken"},/area/vault/spacepond)
"bn" = (/mob/living/simple_animal/hostile/carp,/turf/simulated/floor/wood,/area/vault/spacepond)
"bo" = (/obj/machinery/door/mineral/wood,/turf/unsimulated/floor/asteroid,/area/vault/spacepond)
"bp" = (/obj/structure/flora/ausbushes/reedbush,/turf/unsimulated/beach/sand,/area/vault/spacepond)
"bq" = (/obj/machinery/door/airlock/external,/turf/simulated/floor/wood,/area/vault/spacepond)
"jh" = (/mob/living/simple_animal/hostile/carp/baby,/turf/unsimulated/beach/water,/area/vault/spacepond)
"tF" = (/obj/structure/hanging_lantern,/turf/unsimulated/beach/sand,/area/vault/spacepond)
"wY" = (/obj/jectie_time,/turf/unsimulated/floor/asteroid,/area/vault/spacepond)
"Dg" = (/obj/machinery/door/mineral/sandstone,/turf/unsimulated/floor/asteroid,/area/vault/spacepond)
"Ix" = (/obj/jectie_time,/turf/unsimulated/beach/sand,/area/vault/spacepond)
"SZ" = (/obj/structure/hanging_lantern{dir = 1},/turf/unsimulated/beach/sand,/area/vault/spacepond)
"Tu" = (/obj/effect/decal/cleanable/campfire,/turf/unsimulated/floor/asteroid,/area/vault/spacepond)
"Zl" = (/obj/structure/hanging_lantern{dir = 4},/turf/unsimulated/floor/asteroid,/area/vault/spacepond)

(1,1,1) = {"
aaaaaaaaaaaaaaaaabaaaaaaaaaaaaaaaaaaacacacacacacacacaaaaaa
aaaaaaaaaaaaaaaaababaaabababaaaaaaaaacagacadahaeafacaaaaaa
aaaiaiaaaaaaaaaaababababajabababacacacaVacalanalamacabaaaa
aiaiaiaaaaaaaaababababaiaiaiaiaiacauavaoapaRaxasatacababaa
aaaiaaaaaaaaababaiabaiayaiawaBaiacaDaCaCararaRaraFbfaiabaa
aaaaaaacacacacacaiaIaiaiaPaQaEaibfaSaCaHaAaraJaWaKaLaMaNaO
aaaaaaacaXaZaRacaiaiaiaiababbaaibfbcaCaUacaVacakbeacaiabab
aaaaaaacbgbiaYacaiaiaiaiaibjblbbacbfbmacacbnacbfacacaiaiab
aaaaaaacacboacacbhbhbpbhbhbhaiaiaiaiaibhacbqacbhaiaiaiabab
ababababaiaibhbhbhbkbkbkbkbhbhaiaiaiaibhSZbhbhaiaiaiaiabaa
aaabaiaiaiaibhbpbkbkbkbkbkbkbhbhbhbhbhbhbhbhaiaiwYaiaiabaa
aaababaiaibhbpbkbkbkbkbkbkbkbkbhIxbhbhbhaiaiaiaibhaiaiDgaa
aaaaababaibhbkbkjhbkbkbkbkbkbkbhbhaiaiaiabaiaibhbhaiaiabaa
aaababaibhbhbkbkbkbkbkbkjhbkbkbhaiaiaiZlababaiaiaiaiababaa
aaaaabaibhbhbhbkbkbhbkbkbkbhbhbhaiTuaiaiaiabaiaiaiaiabaaaa
aaaaabaiaibhbhbhbpbhbhbhbhbhbhaiaiaiaiaiaiababaiabababaaaa
aaaaabaiaiaiaiaiaitFbhabaiaiwYaiaiaiaiaiabababababaaaaaaaa
aaaaababaiaiaiaiaiababababaiaiaiaiababababaaababaaaaaaaaaa
aaaaaaabababaiaiabababaiaiaiaiaiababaaaaaaaaaaabaaaaaaaaaa
aaaaaaaaaaababababaaabababDgabababaaaaaaaaaaaaaaaaaaaaaaaa
"}
